R 1920 108000000000

NO textures/rupi.xpm
SO textures/bo.xpm
WE textures/crro.xpm
EA textures/edi.xpm
S textures/item.xpm

C 135,206,2   35
F 154,205,5   0 

1111111111111111111111111
10000000011000000001N1001
1011000001110001020010001
1001000200000010100000001
1111111110110001011100001
1000000000110000011101111
1000020000002000110101001
1100000111010101111101111
1111111111111111111111111