R 1920 1080

NO textures/rupi.xpm
SO textures/bo.xpm
WE textures/crro.xpm
EA textures/edi.xpm
S textures/item.xpm

F 0,76,211
C 16,255,3

111111111111111111111111
1000000000110000000000001
1011000001110011120000001
100100000000001S100000001
1111111110110011111100001


1000000000110000011101111
1000000000000000110101001
1100000111010101111101111
1111111111111111111111111