R 1920 108000000000

NO textures/rupi.xpm
SO textures/bo.xpm
WE textures/crro.xpm
EA textures/edi.xpm
S textures/item.xpm

C 135,206,2   35
F 154,205,5   0 

1111111111111111111111111
10000000011000000000S2001
1011000001110001020000001
1001000200020000100002001
1111111110110001011100001
1000000020110000011101111
1000020000020000020001001
1100000111010101111101111
1111111111111111111111111